NO ./textur/wall.xpm     
SO ./textur/blue.xpm 
WE ./textur/red.xpm          
EA  ./textur/wall2.xpm         

F 9,164,19
C 30,248,255

111111111111111
100100000000001
100100000010001
100111111110001
100010010000001
100010010000001
100000000000001
100000000000001
111101000000001
1000010N0000001
111111111111111