 NO ./main.c
   SO ./main.c

		WE ./main.c          
EA     ./main.c

F 255,255,255
C 225,255,0

111111111111111
100000000000001
100000000000001
100001000100001
100000000000001
100000010000001
100000000000001
100001000100001
100000000000001
10E000000000001
111111111111111