 NO ./textur/grass.xpm     
          SO ./main.c

		WE ./main.c             
EA     ./main.c         

F 9,164,19
C 30,248,255

111111111111111
100100000000001
100100000010001
100111111110001
100010010000001
100010010000001
100000000000001
10000000N000001
111101000000001
100001000000001
111111111111111