 NO ./main.c
   SO ./main.c

		WE ./main.c          
EA     ./main.c

F 255,255,255
C 225,255,0

111111111111111
100000101000001
100000010000001
100000100100001
110001000000101
101000111100001
100010000010001
11000000N000101
101000000000101
101000010000001
111111111111111