NO mandatory/textur/original_blue.xpm     
SO mandatory/textur/green.xpm 
WE mandatory/textur/red.xpm          
EA  mandatory/textur/wall2.xpm    

F 9,164,19
C 30,248,255

1111111111111111111111111111111111111111111111111
1000000000000000100001000000000000010000000000001
10000001000000001000000000000010000100000010000001
10000010010000001111110000000010000100011100011111
11111111111110001000000000000011111100000000000001
10100011110000001000000000000000000111110000011111
100010000010000W0000000000000000000100000000000001
11000000000010000001110000000000000000000000000001
10100000000010000000010000000000000011111111100111
10100001000000000000010000000000000010000000000001
11111111111111111111111111111111111111111111111111