

F 9,164,19
C 30,248,255

NO bonus/textur/original_blue.xpm     
SO bonus/textur/green.xpm 
WE bonus/textur/red.xpm          
EA  bonus/textur/wall2.xpm           

111111111111111
1001000000000001
100100000010001
100111111110001
100010010000001
100010010000001
100000000000001
10E000000000001
111101000000001
100001000000001
111111111111111